Year,Total_Store_Closures,Independent_Store_Closures,Chain_Store_Closures,Daily_Average_Closures,Economic_Growth_Rate,Consumer_Confidence_Index
2015,8788,5234,3554,24,2.4,98
2016,9783,6012,3771,27,1.7,95
2017,10234,6789,3445,28,1.7,92
2018,12456,8123,4333,34,1.3,88
2019,14896,9567,5329,41,1.4,85
2020,16045,10496,5549,44,-9.3,67
2021,17145,11090,6055,47,7.5,74
2022,11459,8801,2658,31,4.2,82
2023,14801,7793,7008,41,0.5,85
2024,13479,11341,2138,37,1.1,89
2025,17350,14660,2690,48,1.8,92
